# **************************************************************************** #
#                                                                              #
#                                                         :::      ::::::::    #
#    example_no_room.map                                :+:      :+:    :+:    #
#                                                     +:+ +:+         +:+      #
#    By: enanrock <marvin@42.fr>                    +#+  +:+       +#+         #
#                                                 +#+#+#+#+#+   +#+            #
#    Created: 2017/10/05 11:44:06 by enanrock          #+#    #+#              #
#    Updated: 2017/10/19 15:20:27 by enanrock         ###   ########.fr        #
#                                                                              #
# **************************************************************************** #
# **************************************************************************** #
#               ,                                                              #
#      _,-'\   /|   .    .    /`.                                              #
#   _,-'     \_/_|_  |\   |`. /   `._,--===--.__                               #
#  ^      _/"/  " \ : \__|_ /.   ,'    :.  :. .`-._                            #
#        // ^   /7 t'""    "`-._/ ,'\   :   :  :  .`.                          #
#        Y      L/ )\         ]],'   \  :   :  :   : `.                        #
#        |        /  `.n_n_n,','\_    \ ;   ;  ;   ;  _>                       #
#        |__    ,'     |  \`-'    `-.__\_______.==---'                         #
#       //  `""\\      |   \            \                                      #
#       \|     |/      /    \            \                                     #
#                     /     |             `.                                   #
#                    /      |               ^                                  #
#                   ^       |                                                  #
#                           ^                                                  #
# **************************************************************************** #
12
0-4
0-6
1-3
4-3
5-2
3-5
4-2
2-1
7-6
7-2
7-4
6-5
